042E03A1
C2A75085
B0480000
00000000
AAB64C4B
00AAB638
464EAAB6
4C5A00AA
B6334664
3C465A2D
32011E00
05018802
00050000
00000000
00000000
16000000
000000FF
00050000
00000000
00000000
